@	@	@U
3	3
a	a	aI	aU
b	b
d	d	dZ
D	D
E	E	EI
f	f
g	g
h	h
I	I	I@
i	i
j	j
k	k
l	l
m	m
n	n
N	N
O	O
p	p
Q	Q
r	r
s	s
S	S
t	t	tS
T	T
U	U
u	u
v	v
V	V
w	w
z	z
